DESC:这是一个可以查看一些图片的源
Example:https://rsshub.app/1x
Route: /1x/:category?
Parameters:optional - Category, Latest awarded by default, see below
Category	Title
Latest awarded	latest
Popular	popular
Latest published	published
Abstract	abstract
Action	action
Animals	animals
Architecture	architecture
Conceptual	conceptual
Creative edit	creative-edit
Documentary	documentary
Everyday	everyday
Fine Art Nude	fine-art-nude
Humour	humour
Landscape	landscape
Macro	macro
Mood	mood
Night	night
Performance	performance
Portrait	portrait
Still life	still-life
Street	street
Underwater	underwater
Wildlife	wildlife



